NO PATH_IMAGE
SO PATH_IMAGE
WE PATH_IMAGE
EA PATH_IMAGE
F 30, 120, 210
C 123, 123, 123
		    0111111111111113
1000001 10001 11000010000000000001
10000001000010011111111111111
1000000N0000p001
1111111111111111
1111111111111111111111111
11111111111111111111111
00000000000000000000001
10000000000000000000000001
100000000000000000000000011
10000000000000000000000001
10000000000000000000000001
11111111111111111111111111