NO PATH_IMAGE
SO PATH_IMAGE
WE PATH_IMAGE
EA PATH_IMAGE
F 30, 120, 210
C 123, 123, 12


11111111111111111111
100000000 000000001111
10000000000000000011
10000000000000000011
10000000000000000011
10000000000000000011
11111111111111111111