NO PATH_IMAGE
SO PATH_IMAGE
WE PATH_IMAGE
EA PATH_IMAGE
F 30, 120, 210
C 123, 123, 123
		    1111111111111111
111111111111110000000N0000001
10000000000000010000000000001
10000000000000011111111111111
1000000N0000p001
1111111111111111
